3 3 3 3 3 3 5 3 3 3 3 3 3 3 3 3
3 0 0 0 0 0 0 0 0 0 0 0 0 0 0 3
3 0 0 0 0 0 0 0 0 0 0 0 0 0 0 3
3 1 1 1 1 1 6 1 1 1 1 1 2 1 1 3
3 0 0 0 0 0 0 0 0 0 0 0 0 0 0 3
3 1 1 2 1 1 7 1 1 1 1 1 1 1 1 3
3 0 0 0 0 0 0 0 0 0 0 0 0 0 0 3
3 1 1 1 1 1 8 1 1 1 1 1 2 1 1 3
3 0 0 0 0 0 0 0 0 0 0 0 0 0 0 3
3 1 1 2 1 1 9 1 1 1 1 1 1 1 1 3
3 0 0 0 0 0 0 0 0 0 0 0 0 0 0 3
3 3 3 3 3 3 4 4 4 4 3 3 3 3 3 3